GEOFILE
20 60
n n n n n n n n n n n n n n n n n n n n n n n n n n n n n n n n n n b b b b b b b b b b b b b b b b b b b b b b b b b b
n n n n n n n n n n n n n n n n n n n n n n n n n n n n n n n n n n b b b b b b b b b b b b b b b b b b b b b b b b b b
n n n n n n n n n n n n n n n n n n n n n n n n n n n n n n n n n n b b b b b b b b b b b b b b b b b b b b b b b b b b
n n n n n n n n n n n n n n n n n n n n n n n n n n n n n n n n n n b b b b b b b b b b b b b b b b b b b b b b b b b b
n n n n n n n n n n n n n n n n n n n n n n n n n n n n n n n n n n b b b b b b b b b b b b b b b b b b b b b b b b b b
n n n n n n n n n n n n n n n n n n n n n n n n n n n n n n n n n n b b b b b b b b b b b b b b b b b b b b b b b b b b
n n n n n n n n n n n n n n n n n n n n n n n n n n n n n n n n n n b b b b b b b b b b b b b b b b b b b b b b b b b b
n n n n n n n n n n n n n n n n n n n n n n n n n n n n n n n n n n b b b b b b b b b b b b b b b b b b b b b b b b b b
n n n n n n n n n n n n n n n n n n n n n n n n n n n n n n n n n n b b b b b b b b b b b b b b b b b b b b b b b b b b
n n n n n n n n n n n n n n n n n n n n n n n n n n n n n n n n n n b b b b b b b b b b b b b b b b b b b b b b b b b b
n n n n n n n n n n n n n n n n n n n n b n n n n n n n n n n n n n b b b b b b b b b b b b b b b b b b b b b b b b b b
n n n n n n n n n n n n n n n n n b n n b n n n n n n n n n n n n n b b b b b b b b b b b b b b b b b b b b b b b b b b
n n n n n n n n n n t t t n n b n b n n b n n n n n n n n n n n n n b b b b b b b b b b b b b b b b b b b b b b b b b b
n n n n n n n n b b b b b b b b b b b b b b b b b b b b b b n n n n b b b b b b b b b b b b b b b b b b b b b b b b b b
n n n n b b b b b b b b b b b b b b b b b b b b b b b b b b n n n n b b b b b b b b b b b b b b b b b b b b b b b b b b
n n n n n n n n n n n n n n n n n n n n n n n n n n n n n n n n n n b b b b b b b b b b b b b b b b b b b b b b b b b b
n n n n n n n n n n n n n n n n n n n n n n n n n n n n n n n n n n b b b b b b b b b b b b b b b b b b b b b b b b b b
n n n n n n n n n n n n n n n n n n n n n n n n n n n n n n n n n n b b b b b b b b b b b b b b b b b b b b b b b b b b
n n n n n n n n n n n n n n n n n n n n n n n n n n n n n n n n n n b b b b b b b b b b b b b b b b b b b b b b b b b b
b b b b b b b n n n n n n n n n n n n n n n n n n n n n n n n n n n b b b b b b b b b b b b b b b b b b b b b b b b b b
