GEOFILE
20 30
n n n n n n n n n n n n n n n n n n n n n n n n n n n n n n
n n n n n n n n n n n n n n n n n n n n n n n n n n n n n n
n n n n n n n n n n n n n n n n n n n n n n n n n n n n n n
n n n n n n n n n n n n n n n n n n n n n n n n n n n n n n
n n n n n n n n n n n n n n n n n n n n n n n n n n n n n n
n n n n n n n n n n n n n n n n n n n n n n n n n n n n n n
n n n n n n n n n n n n n n n n n n n n n n n n n n n n n n
n n n n n n n n n n n n n n n n n n n n n n n n n n n n n n
n n n n n n n n n n n n n n n n n n n n n n n n n n n n n n
n n n n n n n n n n n n n n n n n n n n n n n n n n n n n n
n n n n n n n n n n n n n n n n n n n n n n n n n n n n n n
n n n n n n n n n n n n n n n n n n n n n n n n n n n n n n
n n n n n n n n n n n n n n n n n n n n n n n n n n n n n n
n n n n n n n n n n n n n n n n n n n n n n n n n n n n n n
n n n n n n n n n n n n n n n n n n n n n n n n n n n n n n
n n n n n n n n n n n n n n n n n n n n b n n n n n n n n n
n n n n n n n n n n n n n n n n n b n n b n n n n n n n n n
n n t n n t t n n n t t t n n b n b n n b n n n n n n n n n
b b b b b b b b b b b b b b b b b b b b b b b b b b b b b b
b b b b b b b b b b b b b b b b b b b b b b b b b b b b b b
